Aquatic and marine mammals

    Bahamut -  Whale monster whose body supports the earth. Word seems far more ancient than Islam and may be origin of the word Behemoth in modern Judeo-Christian lore.
    Bake-kujira  – Ghost whale
    Cetus  – a monster with the head of a boar or a greyhound, the body of a whale or dolphin, and a divided, fan-like tail
    Devil Whale  – Whale capable of swallowing ships
    Encantado  – shapeshifting trickster dolphins
    Glashtyn  – Horse goblin from the sea
    Makara  – half terrestrial animal in the frontal part  and half aquatic animal in the hind part 
    Mug-wamp -  giant sturgeon monster said to inhabit Lake Temiskaming in Ontario. Name is of Native origin. Monster may also be Native, but name was given from Native language by local whites & not the original name, if so.
    Sea goat  – Half goat, half fish
    Selkie  – Shapeshifting seal people
    Water bull  – Nocturnal amphibious bull
    Water Horse – General name for mythical water dwelling horses of many cultures
        Ceffyl Dŵr  – Water horse
        Each-uisge  – Malevolent shapeshifting oceanic water horse
        Enbarr  – Manann's horse, capable of traversing land and sea
        Hippocampus  – Horse with a fish tail
        Ichthyocentaurs  – Upper body of a man, the lower front of a horse, tail of a fish
        Kelpie  – Water horse
        Morvarc'h  – Legendary horse that could gallop on the waves
        Nixie  – Shapeshifting water being, known for appearing as horses
        Nuckelavee  – Skinless oceanic water horse with pestilent breath
        Nuggle  – Mischievous male water horse
        Tangie  – Shapeshifting sea water horse

Arthropods

    Anansi  – Trickster spider
    Arachne  – Weaver cursed into a spider
    Carbuncle  – one of its many descriptions is a greenish-red fiery light reminiscent of fireflies
    Gold-digging ant  – Reported by Herodotus to live in either Ethiopia or Indian subcontinent
    Iktomi -  Name for a very narrowly believed in trickster spider. Also known in parts of the Rockies.
    Jorōgumo  – Ghost woman who shapeshifts into a spider
    Karkinos  – Cancer the crab
    Khepri  – Beetle who pushes the sun
    Mothman  – Man with moth wings and features
    Myrmecoleon  – Ant-lion
    Myrmidons  – Warriors created from ants by Zeus
    Pabilsag  – Sagittarius-like creature with scorpion tail
    Scorpion man  – Protector of travellers
    Selket  – Scorpion death/healing goddess
    Tsuchigumo  – Shapeshifting giant spider

Bats

    Balayang  – Bat-god and brother to Bunjil
    Camazotz  – Bat spirit and servant of the lords of the underworld
    Leutogi  – Samoan princess rescued by bats
    Minyades  – Three sisters who refused to take part in the worship of Dionysus, and turned into bats by Hermes.
    Tjinimin  – Ancestor of the Australian people
    Vetala  – Vampiric entity that takes over cadavers.

Birds

    Ababil  – a miraculous bird
    Adarna  – has healing powers, put people to sleep, and turn people into stone
    Avalerion  – only a single pair was said to live at any time
    Alicanto  – bird with luminescent feathers which feeds on gold or silver [1]
    Anqa  – large mysterious or fabulous female bird
    Anzû  – massive bird who can breathe fire and water
    Bare-fronted Hoodwink  – bird with the ability to be "almost seen"

    Bird People
        Alkonost  – female with body of a bird
        Gumyōchō  – twin-headed human-bird
        Harpy  – ugly winged bird woman, steals food
            Aello – name meaning "storm"
            Ocypete – name meaning "swift wing"
            Celaeno – name meaning "the dark one"
            Podarge – name meaning "fleet-footed"
        Horus  – deity
        Inmyeonjo  – bird with a human face
        Kalavinka  – a fantastical immortal creature in Buddhism, with a human head and a bird's torso and long flowing tail
        Karura  – divine creature with human torso and birdlike head
        Kinnara  – Half-bird musicians
        Siren  – Bird-women known for their compelling singing
            Achelois – name meaning "she who drives away pain", surname for the daughters of Achelous
            Aglaonoe – Daughter of Achelous and Terpsichore
            Agalaope – name meaning "with lambent voice", daughter of Achelous and Terpsichore
            Leucosia – name meaning "white", daughter of Achelous and either Melpomene or Terpsichore
            Ligeia – name meaning "clear-toned", daughter of Achelous and either Melpomene or Terpsichore
            Parthenope – name meaning "maiden-voiced", Daughter of Achelous and Terpsichore
            Pisinoe – daughter of Achelous and either Melpomene or Sterope
            Thelxinoë – name meaning "mind charming"
        Swan maiden  – shapeshifts from human to swan

    Caladrius  – white bird with healing powers
    Chalkydri  – heavenly creatures of the Sun
    Chamrosh  – body of a dog, head & wings of a bird
    Cinnamon bird  – greek myth of an arabian bird that builds nests out of cinnamon
    Devil Bird  – shrieks predicting death
    Gagana  – a miraculous bird with an iron beak and copper claws
    Gandabherunda  – two-headed magical bird
    Gamayun  – prophetic bird with woman's head
    Garuda  – known as the primordial bird and the progenitor of all birds; vehicle of Lord Vishnu
    Hakawai  – bird that was sometimes heard but not usually seen
    Hudhud  – messenger to prophets
    Huginn and Muninn  – two ravens that serve as messengers 
    Itsumade  – monstrous bird with a human face
    Jingwei  – a bird who is determined to fill up the sea
    Lamassu  – goddess with a human head, the body of a bull or a lion, and bird wings
    Luan  – a bird which carries a shield and tramples on snakes while wearing one on its breast
    Minokawa  – Giant, Dragon-like bird in Philippines 
    Nachtkrapp  – The Night Raven
    Nine-headed Bird  – a totem creature, predecessor to the Fenghuang
    Oozlum bird  – 
    Pamola  – bird/moose spirit who causes cold weather
    Peng  – an enormous bird transformed from a giant fish which flies over the great oceans 

    Phoenix  –
        Bennu  – self-creating bird deity
        Chol  – regenerative bird
        Firebird  – legendary bird with glowing eyes and feathers, brings misfortune if captured.
        Fenghuang  – a phoenix who reigns over all other birds
        Huma bird  – a bird that flies too high to be seen and never lands
        Konrul and Toghrul 
        Vermilion Bird 

    Piasa  Based on monster depicted on real Illinois rock painting on the Mississippi River and a local native word for Thunderbird, but the Piasa itself is uniquely an American creation. The painting actually originally depicted an Underwater Panther.[2]
    Qingniao  – blue or green messenger birds of the Queen Mother of the West 
    Ra  – Deity
    Rain Bird  – bird who brought rain
    Raróg  – fiery demon falcon
    Roc  – enormous legendary bird of prey
    Shangyang  – rainbird
    Shedu  – male counterpart to Lamassu
    Simurgh 
    Stymphalian birds  – man-eating birds
    Tengu  – has human and bird characteristics, name means dog
    Three-legged bird 
    Thunderbird  – 
    Thoth  – deity
    Turul  – mythological bird of prey
    Veðrfölnir -  a hawk that sits atop an eagle that rests atop the world tree, Yggdrasil.
    Vucub Caquix  – bird demon
    Wampum Bird-  Giant heron with shell armor instead of feathers.
    Yatagarasu  – three-legged crow
    Zhenniao  – poisonous bird

Chickens

    Alectryon – rooster 
    Basan, a fire-breathing chicken from mythology
    Cockatrice, a chicken-headed dragon or serpent, visually similar to or confused with the Basilisk.
    Gallic rooster, a symbolic rooster used as an allegory for France
    Gullinkambi, a rooster who lives in Valhalla in Norse mythology
    Rooster of Barcelos, a mythological rooster from Portugal
    Sarimanok, a legendary chicken of the Maranao people who originate from Mindanao 
    Víðópnir, a rooster that sits atop Yggdrasil in Norse mythology

Eagles

    Aethon – eagle tormentor of Prometheus
    Griffin – guards treasure and priceless possessions 
    Hippogriff – winged horse with the head and upper body of an eagle 
    Hræsvelgr – jötunn who takes the form of an eagle 
    Poukai  – monstrous predatory bird, likely based on an extinct species
    Shahbaz  – a god who helped the Iranian peoples and guided the Faravahar to the Iranian lands
    Triple-headed eagle  –
    Wuchowsen -  One of the four wind spirits in Abenaki lore. Depicted as a giant eagle who lives atop a mountain.
    Ziz  – giant griffin
    Zu – divine monster depicted as a lion-headed eagle

Owls

    Nyctimene  – Transformed into an owl by Minerva.
    Owlman – compared to America's Mothman 
    Sirin  – birds with women heads, lured men to their death
    Strix – owl that ate human flesh 

See also: Category:Legendary birds
Carnivorans
Bears

    Bugbear  – child-eating hobgoblin
    Callisto  – A nymph who was turned into a bear by Hera.
    Stiff-Legged Bear-  giant, hairless bear monster. Colonial interpretations also turned it into a pig monster, with tusks or tried to associate it with the Mammoth or Mastodon, during a time when colonial settlers believed such animals likely still existed somewhere in the continent.

See also: Category:Mythological bears
Canines

    Adlet
    Amarok
    Anubis – jackal-headed god associated with mummification and the afterlife 
    Aralez
    Asena
    Axehandle hound – a dog-like beast that reputedly subsists on axe-handles left unattended 
    Black dog, also known as Barghest, Black Shuck, or Grim – associated with the Devil, Hellhound 
    Beast of Gévaudan – man-eating wolf, terrorized the province of Gévaudan 
    Carbuncle  – one of its many descriptions is a luminescent small dog[3]
    Cerberus – multi-headed dog, guards the gates of the Underworld, son/brother of Orthrus 
    Chupacabra  – Alleged creature reputed to attack and drink the blood of livestock, occasionally described with bat-like features. Sometimes thought to resemble, or mistaken for a hairless coyote.
    Cu Sith  – Hellhound, harbinger of death 
    Crocotta – mythical dog-wolf, related to the hyena 
    Cynocephaly – having the head of a dog or jackal
    Dogs of Actaeon – Hunting dogs that turned on Actaeon after he was turned into a deer
    Fenrir – monstrous wolf, father of the wolves 
    Gelert
    Hellhound – supernatural dog, bringers of death 
    Huli jing or Kitsune or Kumiho – Fox spirits, like Fairies 
    Huodou – a large black dog that can emit flames from its mouth 
    Orthrus – two headed dog, father/brother of Cerberus 
    Penghou – tree spirit that appears like a black dog and tastes like dog-meat 
    Salawa – the "Typhonian Animal," a slender, vaguely canine-animal that is the totemic animal of Set
    Sigbin – is a creature in Philippine mythology 
    Sky Fox , a celestial nine-tailed Fox Spirit that is 1,000 years old and has golden fur 
    Shug Monkey – dog/monkey creature found in Cambridgeshire 
    Tanuki – raccoon dog, legends claim is a shapeshifting trickster 
    Vǎrkolak, or "Vukodlak"  – undead vampire werewolf
    Werewolf – human, shapeshifts to a wolf because of an affliction, lycanthrope 

See also: Category:Mythological canines
Felines

    Bael  – First king of Hell with three heads: a man, a toad, and a cat
    Ball-tailed cat  – a feline similar to a mountain lion, except with a long tail with a bulbous end used for striking its prey
    Cactus cat  – a feline of the American Southwest with hair-like thorns that intoxicates itself by the consumption of cactus water
    Canaima-  term for a sort of were-jaguar. May be related to skinwalkers.
    Cat-sìth  – spectral cat that haunts the Scottish Highlands
    Cath Palug  – a monstrous cat said to have killed 180 warriors
    Carbuncle  – one of its many descriptions is a cat with a luminescent chin[4]
    Demon Cat  – a ghost cat who is purported to haunt the government buildings of Washington, D.C.

    Kaibyō  – various forms of cat Yōkai
        Bakeneko  – two tailed cat yōkai
        Kasha  – corpse stealing yōkai, sometimes originating as a cat
        Nekomata  – cat yōkai from both mountains and domestic areas

    Nue 
    Panther

    Phantom cat, Alien Big Cat
        Blue Mountains panther
    Glawackus 

    Tyger
    Underwater panther
    Vapula
    Wampus cat -  Said to have various Native origins in Southern Appalachia. Cat with six legs and a long tail. Was said to have once been a man who was cursed into a monster after losing his love to another man. May have been loosely based on some version of the Underwater Panther mythos.
    White Tiger  – a Guardian Of The West cardinal point
    Winged cat

Lions

    Arimanius  – minor lion-headed greek god
    Ammit  – goddess with the forequarters of a lion, the hindquarters of a hippopotamus, and the head of a crocodile
    Barong  – Benevolent king of spirits.
    Beast of the First Kingdom  – A beast like a lion with eagle's wings seen in the Book of Revelations.
    Brunswick Lion  – Loyal companion of Henry the Lion after the two slew a dragon together.
    Chimera  –
    Chinese guardian lions  – Statues depicted in pairs believed to be protectors
        Komainu 
        Shisa 
        Sin-you 
        Xiezhi 
    Dawon  – Mount of the goddess Durga
    Egyptian lion gods – Lions were a symbol of warfare and most all of these gods were warriors
        Aker – earth and underworld god
        Ȧmi-Pe – A lion god
        Apedemak – depicted as a figure with a male human torso and a lion head
        Bast – Lioness goddess of fertility and protection against disease.
        Hert-ketit-s
        Ḥuntheth – A lioness goddess
        Ipy  – head and feet of a lion, body of a hippo, arms of a human
        Maahes – name means "he who is true beside her"
        Matit – A funerary cat goddess who had a cult center at Thinis
        Mehit – depicted as a reclining lioness with three bent poles projecting from her back
        Menhit
        Pakhet
        Repyt
        Sekhmet – warrior goddess as well as goddess of healing
        Seret – A lioness goddess possibly originally from Libya
        Shesmetet
        Taweret – depicted as a hippopotamus with lion paws and crocodile tail
        Tefnut –
        Tutu – body of a striding, winged lion, the head of a human, other heads of hawks and crocodiles projecting from the body, and the tail of a serpent
        Urit-en-kru – A lioness headed hippopatomus goddess
    Griffin 
    Lamassu 
    Lampago mythical heraldic beast in the form of a "man-tiger or man-lion"
    Leo  –
        Lion of Cithaeron 
        Nemean lion 
    Lion of Al-lāt  – lion icon of Al-Lat
    Manticore
    Manussiha  – statue with a human head and two lion hindquarters
    Merlion  – a fish with a lion's head
    Narasimha 
    Nian  – a flat-faced lion with the body of a dog and prominent incisors, warded away by New Year's celebrations.
    Nongshāba 
    Pixiu  – powerful, winged lions who protect Feng shui practitioners
    Questing Beast  – Beast with the head and neck of a snake, the body of a leopard, the haunches of a lion, and the feet of a hart.
    Sea-lion
    Serpopard  – Lion/leopard body with a snake head.
    Sharabha  – part Lion, part bird-beast, with eight legs.
    Simhamukha  – a wisdom dakini of the Dzogchen tradition with the head of a snow lion
    Snow Lion  – a celestial animal of Tibet
    Sphinx  –
        Criosphinx  – ram-headed sphinx
        Gopaitioshah  – being a winged bull or lion with human face
        Hieracosphinx  – has the head of a hawk and the body of a lion.
    Stratford Lyon
    Tigris – giant lion of the forest of Bei Ilai
    Vaikuntha Chaturmurti  – a four-headed aspect of the Hindu god Vishnu: a human head, a lion head, a boar head and a fierce head
    Winged lion
    Yali   – Portrayed with the head and the body of a lion, the trunk and the tusks of an elephant, and sometimes bearing equine features.
    Yaghūth – a god of the era of the Prophet Noah
    Yaldabaoth  – lion-headed serpent god.

See also: Category:Mythological felines
Hyenas

    Werehyena
    Kishi – cannibalistic two-faced demon, half-human half-hyena 

Musteloids, mongoose and civets

    Azeban
    Gef
    Ichneumon
    Kamaitachi
    Kushtaka  – shapeshifting "land otter man"
    Mujina
    Ramidreju
    Raijū

Procyonids

    Azeban is a lower-level trickster spirit in Abenaki mythology. The traditional homeland of the Abenaki is Wobanakik , what is now called northern New England and southern Quebec. Azeban  is a raccoon, the Abenaki trickster figure. Pronounced ah-zuh-bahn. Azeban does many foolish and/or mischievous things in Abenaki folktales, but unlike animal tricksters in some other tribes, is not dangerous or malevolent.

Fish

    Fish People
        Mermaid / Merman – half-human, half-fish 
        Water spirit – 
        Undine – water elementals in the alchemical writings of Paracelsus
    Abaia
    Gurangatch
    Hippocamp
    Ika-Roa
    Isonade
    Namazu
    Ningyo
    Kun
    Salmon of Wisdom
    Shachihoko  – a creature with the head of a tiger and the body of a carp

See also: Category:Mythical fish
See also: Category:Legendary fish
Insectivores

    Lavellan A Lavellan, làbh-allan, la-mhalan or la-bhallan etc. is a mythological creature from northern Scotland. It was generally considered to be a kind of rodent, and indeed the name "làbh-allan" is also used for a water shrew or water vole in Scottish Gaelic. It was however, reportedly larger than a rat, very noxious, and lived in deep pools in rivers. Its poisonous abilities were legendary, and it was said to be able to injure cattle over a hundred feet away.

Marsupials

    Drop bear
    Bunyip 

Molluscs

    Akkorokamui – octopus monster 
    Carbuncle  – one of its many descriptions is a luminescent bivalve[4][3]
    Lou Carcolh – A giant, man-eating snail with fur and tentacles 
    Kraken – squid monster 
    Shen – A clam-dragon that creates mirages and fata morgana at sea 

Primates

    Agropelter – a beast that amuses itself by hurling twigs and tree branches at passersby 
    Bigfoot or Sasquatch – Cryptid, animal of the Northwest 
    Hibagon or Hinagon – ape-like, similar to Bigfoot, or the Yeti 
    Jué yuán – blue-furred man-sized rhesus monkey that abducts human women 
    Satori – mind-reading magical ape or monkey 
    Shōjō – anthropomorphic spirit, depicted as furred, somewhat confounded with orangutan 
    Shug Monkey – dog/monkey 
    Sun Wukong  – powerful warrior-magician in the form of a monkey who hatched from a stone egg 
    Vanara – humanoid apes or monkeys 
    Yeren – man-monkey, cryptid hominid, resides in remote mountainous 
    Yeti – Abominable Snowman, ape-like cryptid similar to Bigfoot, that inhabits the Himalayas 
    Yowie – hominid said to live in the Australian wilderness, a cryptid similar to the Himalayan Yeti 

See also: Category:Mythological monkeys
Rabbits and hares

    Al-Mi'raj – rabbit with unicorn horn 
    Jackalope – 
    Moon rabbit – a rabbit living on the moon 
    Skvader
    Wisakedjak -  aka Whiskeyjack. One of several names for the rabbit trickster spirit believed in across the Eastern Woodlands and Great Plains.
    Wolpertinger

See also: Category:Mythological rabbits and hares
Reptiles, Limbed

    Agoa-  turtle monster of West Virginian lore centered around the Monongahela River. Name derived from Lenape language word for snake, but creature completely made up by whites.
    Ammut – female demon, funerary deity and animal hybrid 
    Bakunawa – Serpent-like Dragon in Philippines 
    Basilisk – king of serpents, has the power to cause death with a single glance 
    Black Tortoise – one of the four symbols of the Chinese constellations
    Chalkydri
    Chinese Dragon – serpentine creature with four legs
    Cipactli – sea monster, part crocodile, fish and toad. Always hungry, thousands of mouths 
    Dragon – serpentine, reptilian traits 
    Dungavenhooter – a crocodile creature with no mouth and huge nostrils using its tail to pound victims into a vapor, which it inhales for through its nose
    Knucker – sea serpent like dragon
    Kurma
    Loch Ness Monster – sea monster cryptid 
    Loveland frog – Humanoid cryptid )
    Makara
    Mokele Mbembe
    Morgawr  – Crocodile-like sea serpent that affects fishing
    Mungoon-Gali – a giant goanna 
    Peluda
    Reptilian humanoids
    Sewer alligator
    Sobek
    Taniwha
    Whowie – a giant frog-headed goanna with six legs 
    Wyvern
    Zaratan

See also: Category:Legendary reptiles

Main articles: List of horses in mythology and folklore and List of winged horses
See also: Category:Horses in mythology

    Anggitay – is a creature with the upper body of a female human and the lower body of a horse from waist down 
    Arion – Talking immortal horse 
    Balius and Xanthus Greek – offspring of harpies, immortal
    Buraq – Al-Burāq, steed from the heavens that transported the prophets 
    Centaur – head, arms, and torso of a human, the body and legs of a horse 
    Cheval Gauvin – horse which tries to kill its rider 
    Cheval Mallet; horse that tempts and kidnaps weary travelers 
    Chiron – centaur believed to be exceptional among his brethren 
    Chollima – a winged horse too swift to be mounted by any mortal 
    Drapé -  Ghostly horse monster who finds and spirits away children wandering at night to an unknown location, never to be seen again.
    Haizum – horse of the archangel Gabriel 
    Hippogriff – winged horse with the head and upper body of an eagle 
    Ipotane – half-horse, half-humans, original centaurs 
    Karkadann – monstrous, highly aggressive unicorn 
    Kotobuki  – Yokai with traits of all members of the Chinese zodiac
    Longma – fabled winged horse with dragon scales 
    Mankayia-  tornado spirit in the form of a horse.
    Onocentaur – part human, part donkey 
    Pegasus – white winged stallion 
    Pooka – spirits, or fairies who lived near ancient stones, good or bad 
    Sleipnir – Odin's eight-legged horse, which he rode to Hel  
    Simurgh – like the Hippogriff with the head of a human 
    Sihuanaba – a shapeshifting spirit that typically takes the form of an attractive, long haired woman seen from behind, before revealing her face to be that of a horse
    Tikbalang – creature with the body of a man and the head and hooves of a horse, lurks in the mountains and forests 
    Uchchaihshravas – seven-headed all white flying horse 
    Unicorn – horse-like creature with a single horn, often symbolizing purity 
        Winged unicorn
    Water Horse – General name for mythical water dwelling horses of many cultures
        Ceffyl Dŵr  – water horse
        Each-uisge  – Malevolent shapeshifting oceanic water horse
        Enbarr  – Manann's horse, capable of traversing land and sea
        Hippocampus  – Horse with a fish tail
        Ichthyocentaurs – upper body of a man, the lower front of a horse, tail of a fish 
        Kelpie  – water horse
        Morvarc'h  – Legendary horse that could gallop on the waves
        Nixie  – Shapeshifting water being, known for appearing as horses
        Nuckelave – Skinless oceanic water horse with pestilent breath
        Nuggle  – Mischievous male water horse
        Tangie – shapeshifting sea water horse
    White horse

Pachyderms

    Abath
    Baku
    Behemoth
    Quugaarpak -  Explanation for Mammoths & other Ice Age remains washing out of riversides. Underworld monsters who dig their way up to the human world, but die upon breathing our air.
    Taweret